1111111111111111111111
1000000000001100000001
1111111000001100000001
10000000M00011000E0001
1000000000001100000001
11000P000000M000000001
11M0000011111111111001
1000011111000000000001
1100010C00000000000011
1000000111000000000111
1111111111111111111111