1111111111111111111111
10P0000000001100000001
1111111000001100000001
1000000000001100000E01
1000000000001100000001
1100000000000000000001
1100000011000000000M01
1000011111000000000001
1100010C11000000000001
1000M00111000000000001
1111111111111111111111